Река в Сибири: ВИТИМ
Файл для документов: МУЛЬТИФОРА
Река с красными берегами: ЛЯОХЭ
Острова, открытые в 1529г: МАРШАЛЛОВЫ 
Жадность в еде: АЛЧБА
Самое маленькое растение: ВОЛЬФИЯ
Древнейшее дерево: МАФУСАИЛ 
Одно из названий цитадели: ДЕТИНЕЦ
Зверь с «золотым руном»: ТАКИН
Гора в Казахстане: АКСОРАН
Человек с депрессией: ЛИПОФРЕНИК
Страна с населением 1620 чел.: НИУЭ
Самая удаленная точка: НЕМО
Достопримеч. Берлина: РЕЙХСТАГ
Источники Турции: ПАМУККАЛЕ 
Империя без письменности: ИНКОВ
Запустил eBay в 1995г: ОМИДЬЯР
Музей России: ЭРМИТАЖ
Хранит гос. печать: КАНЦЛЕР
Бессмертная медуза: ТУРИТОПСИС
Область мозга: АМИГДАЛА
Звезда (открыл Иоганн Кеплер): БЕТЕЛЬГЕЙЗЕ
Синоним к слову аллергия: ИДИОСИНКРАЗИЯ
Самая ядовитая змея: ТАЙПАН
Христианский писатель: АПОЛОГЕТ
Водопад Канады: ХЕЛМКЕН
Вечнозеленое растение: ОЛЕАНДР
Помощник претора: АСЕССОР
Пещера в Европе: АГТЕЛЕК
Фильм про высадку в Нормандии: ОВЕРЛОРД
Раздел философии: МЕТАФИЗИКА
Победители ЧМ по футболу 1930: УРУГВАЙ
Харизматичный герой романа Ремарка: КАТЧИНСКИЙ
Мышь, заслужившая цветы на могилу: ЭЛДЖЕРНОН
Известная лошадь и рыба: ПЛОТВА
Фильм с Виктором Цоем: ИГЛА
Композитор Узника замка Иф: ГРАДСКИЙ
Подземные каннибалы Герберта Уэллса: МОРЛОКИ
Исламское государство в Иберии: АНДАЛУСИЯ
Любители верескового мёда: ПИКТЫ